NO ./textures/bmo.xpm
SO ./textures/finn.xpm
WE ./textures/gunter.xpm
EA ./textures/jack.xpm

F 255,0,0

C 225,255,255






11111111111111111111111111111111111
100W0000100000000000000000000000001
10000000100000000000000000000000001
10000000100000000000000000000000001
11111111100000001111000000000000001
10000000000000001001000000000000001
10000000000000001111000000000000001 
10000000000000000000000000000000001
10000000000000000000000000000000001
10000000000011111111111111111111111
100000022000000000000000001
100000000000000000000000001
100000000000000000000000001
100000001110011100000000001
100000001000011100000020001
11111111111111 111111111111
