NO ./textures/bmo.xpm  ./textures/jack.xpm   ./textures/jack2.xpm  ./textures/jack.xpm
SO ./textures/finn.xpm
WE ./textures/gunter.xpm



EA ./textures/jack.xpm

F 220,100,0
C 225,30,0

11111111111111111111111111111111111
10000000000000000000000000000000001
10000000000000000000000000000000001
10000000000000000000000000000000001
10000000000000000010000000000000001
100000000000000001 1000000000000001
10000000000000000010000000000000001
10000000000000000000000000000000001
10000000000000000000000000000000001
10000000000011111111111111111111111
100000020000000000000000001
100000000000000000000000001
100000000000000000000000001
100000000000000000000000001
1000000000000000000000000W1
111111111111111111111111111
