NO ./textures/bmo.xpm  ./textures/jack.xpm   ./textures/jack2.xpm  ./textures/jack.xpm
SO ./textures/finn.xpm
WE ./textures/gunter.xpm



EA ./textures/jack.xpm

F 220,100,0
C 225,30,0

11111111111111111111111111111111111
10000000000000000000000000000000001
10000000000000000000000000000000001
10000000000000000000000000000000001
10000000000000000000000000000000001
10000000000000000000000000000000001
10000000000000000000000000000000001
10000000000000000000000000000000001
10000000000000000000000000000000001
10000000000000000000000000000000001
10000000000000000200000000000000001
10000000000000000000000000000000001
10000000000000000000000000000000001
10000000000000000000000000N00000001
10000000000000000000000000000000001
11111111111111111111111111111111111
